-o--BM-M---M?----M----Mo-??--BB-MXX--MB??-?-Mo----o-B--?o----?-M--o?X---o----MBo-X--Bo?o-o?-----B?--------?----oBB?o--B--BoX--M--MM?--Bo?-MX-----?--------o---Xoo?BB---------T--o-MM-?MBX--?B---Mo--oo-X
M-M-?-X-----|--??-X-TM---o-B--?--?X-X-X-M-B---Bo-??-M?-?----B---M---o-T-----M---Mo-?B-oMo-?MB--Mo--M--B-MB-----B-?B-B--M--?B---X---MB--?-o-?o---XMoX---o--B----??oo?--B?--BM-M-?B--X---?-----M--o------o
o---o-?-XM---o-oB-BM?-?o----B---oM--?X-Mo?M--?oM---M-o---BB--o?-o?-----M--XB-?-?o-?-B---??--MXM-M----M?------oM-o--M-M-T-B-?M?-----B-o--BM-?B-?-?-oBo--o------B--?M-oBBMo-M------B---B??-B---?|BBBX----o
T--M--?-M-BMM-XXo?-M--X---TX-B?-XMM-M--BoXo?----M??-?-Too-o----Bo-oXo?M-Mo--o?BX-?--oMooo--oo-oM??B-B-oBo-M-B--?BBXM-Xo--?MX-BBooM-X-M?oXX?--X-M-B-o--o-----B---MoMBMMXBMo-X--X----B-?oB|-M?Bo-Bo--XB-M?
X-?TBo?oooooMBXToM----?B|XBX??MoBBB-|T?M-BM-Bo-???-BMB-MM--?XBT??o?X?oMXXB?Mo-?MBM??MMM?XMoB|-MX?MM?MB?M-?MoM-B?BXB-Bo?o-o?-BBo-ooB-X?--Xo-BB?XoM-?-ooMMo-Xo?B-?MT??o?B--M-MBB-|?B??Moo-?-B-o-MBB-oo-Mo?
BooMoBoo??M?MB?oBB?MBMM?MMBBoooMoBoB|BMoBo?oBMBoMoBBBoBMBoMoMMBMM?oo?oo?|MooMBMMoMoBMMoMBooBMoBMMMMBMoM?MoMBoMBBMB?|oBooB|BBMBMooBMMoBBBoBoB|ooBMBooM?MBoB?MooM?BBooooBMBBoB?oooooB?BMMMooooBoooBMBBoBo?
?oo|T|oooooo|oTooooooooooo|oooooooTooooooo|oooooT|oo|oToooooooo|o|oooToToooooooooo|o|oo|ToooTooToooooo||ooo|Toooooooo||T|o||oo||ooo|oooooooT|ooo|o|o|o|ooooTooToooTTooTo||oooooooo|oooT|ooooooooooTooToB
?EEEEEEEEEEEEEEEEEEEEEEEEEEEEEEEEEEEEEEEEEEEEEEEEEEEEEEEEEEEEEEEEEEEEEEEEEEEEEEEEEEEEEEEEEEEEEEEEEEEEEEEEEEEEEEEEEEEEEEEEEEEEEEEEEEEEEEEEEEEEEEEEEEEEEEEEEEEEEEEEEEEEEEEEEEEEEEEEEEEEEEEEEEEEEEEEEEEEEEv
-EEEEEEEEEEEEEEEEEEEEEEEEEEEEEEEEEEEEEEEEEEEEEEEEEEEEEEEEEEEEEEEEEEEEEEEEEEEEEEEEEEEEEEEEEEEEEEEEEEEEEEEEEEEEEEEEEEEEEEEEEEEEEEEEEEEEEEEEEEEEEEEEEEEEEEEEEEEEEEEEEEEEEEEEEEEEEEEEEEEEEEEEEEEEEEEEEEEEEEo
oEEEEEEEEEEEEEEEEEEEEEEEEEEEEEEEEEEEEEEEEEEEEEEEEEEEEEEEEEEEEEEEEEEEEEEEEEEEEEEEEEEEEEEEEEEEEEEEEEEEEEEEEEEEEEEEEEEEEEEEEEEEEEEEEEEEEEEEEEEEEEEEEEEEEEEEEEEEEEEEEEEEEEEEEEEEEEEEEEEEEEEEEEEEEEEEEEEEEEEM
?EEEEEEEEEEEEEEEEEEEEEEEEEEEEEEEEEEEEEEEEEEEEEEEEEEEEEEEEEEEEEEEEEEEEEEEEEEEEEEEEEEEEEEEEEEEEEEEEEEEEEEEEEEEEEEEEEEEEEEEEEEEEEEEEEEEEEEEEEEEEEEEEEEEEEEEEEEEEEEEEEEEEEEEEEEEEEEEEEEEEEEEEEEEEEEEEEEEEEEE
?EEEEEEEEEEEEEEEEEEEEEEEEEEEEEEEEEEEEEEEEEEEEEEEEEEEEEEEEEEEEEEEEEEEEEEEEEEEEEEEEEEEEEEEEEEEEEEEEEEEEEEEEEEEEEEEEEEEEEEEEEEEEEEEEEEEEEEEEEEEEEEEEEEEEEEEEEEEEEEEEEEEEEEEEEEEEEEEEEEEEEEEEEEEEEEEEEEEEEE?
TEEEEEEEEEEEEEEEEEEEEEEEEEEEEEEEEEEEEEEEEEEEEEEEEEEEEEEEEEEEEEEEEEEEEEEEEEEEEEEEEEEEEEEEEEEEEEEEEEEEEEEEEEEEEEEEEEEEEEEEEEEEEEEEEEEEEEEEEEEEEEEEEEEEEEEEEEEEEEEEEEEEEEEEEEEEEEEEEEEEEEEEEEEEEEEEEEEEEEE-
|EEEEEEEEEEEEEEEEEEEEEEEEEEEEEEEEEEEEEEEEEEEEEEEEEEEEEEEEEEEEEEEEEEEEEEEEEEEEEEEEEEEEEEEEEEEEEEEEEEEEEEEEEEEEEEEEEEEEEEEEEEEEEEEEEEEEEEEEEEEEEEEEEEEEEEEEEEEEEEEEEEEEEEEEEEEEEEEEEEEEEEEEEEEEEEEEEEEEEE-
mEEEEEEEEEEEEEEEEEEEEEEEEEEEEEEEEEEEEEEEEEEEEEEEEEEEEEEEEEEEEEEEEEEEEEEEEEEEEEEEEEEEEEEEEEEEEEEEEEEEEEEEEEEEEEEEEEEEEEEEEEEEEEEEEEEEEEEEEEEEEEEEEEEEEEEEEEEEEEEEEEEEEEEEEEEEEEEEEEEEEEEEEEEEEEEEEEEEEEEX
XEEEEEEEEEEEEEEEEEEEEEEEEEEEEEEEEEEEEEEEEEEEEEEEEEEEEEEEEEEEEEEEEEEEEEEEEEEEEEEEEEEEEEEEEEEEEEEEEEEEEEEEEEEEEEEEEEEEEEEEEEEEEEEEEEEEEEEEEEEEEEEEEEEEEEEEEEEEEEEEEEEEEEEEEEEEEEEEEEEEEEEEEEEEEEEEEEEEEEEX
