--|-E--o-----XT---ME--------BE-------?-----?------?-------Xo--B--B-------B-B-|------o----o--------B---------T--T---B--------T--|-X-X------|----XX-------B--o-o----------T-E----X|---M-B|-T--------?--Mo-
----M------EET-------?----|-----o----E?|---T--T----?----------T--|-B------|--------------o|-----T-----|---BM------oB-----------X--M-|--|-----M----?-------X----|----------M--M-------E|----|-------E----
---EM---------X--T-?-------|-E--------|TM-?T------?--E--T---X------M------------------M---X---------X--------?------------|------X----?----?-M--X-----T--E--|------Mo--------------------EXE------oM----
----?---------E-------|---TM-T--E-T-----o-----|---|---B--------|---B--------M--oo--------M---XE--X------------|----T----|--X--??-----M--?---M-B-|-------------EE------T|M-M--BXB----?-----X--?-EMM------
----B---------------X--------?--T----B---?-----E----|o-------M------B-----|----|------------X-?-----B----------M---------X---o--------X---E-X-------------X-T-TE-----|------------oB--------------------
-M---oT--BX----T----ETBo----o-M--?-?-------|---------?---B?-----o------------X-T-------E-----T--?-----T-oM?--?B||--M------T------o------?--B-MX-o--B?----------X-X---------o-----------X----?--T-X?-----
--------o--------T?-Eo--B?---------oB--Bo|-----T-------E------oT-??---------B-B--o---|M----X--|M--------X-M|-----------------------------------------------|------------o---XM---|-------EME-------?----
----E------MX--E-B--M----o-----E-----M--EM-E----?M----o----?---oM-T------E---||------X--XE--X------------EEM--M------|----E---??--M-o---X----|-BM-----oM---E|---------?---?------X------------------E--v
-B-E--------Mo----o------T--T---|--------X-E--?-?-------------X----E------?---------?--------------|-E---o---------||--o----oT--------M--M---o|---Bo|--T-EM-M?------------M--E-----B--------X----T----Mf
-o--|-----?T-To--?--M----E---?-T?X-o-?--X|-----------------|---B--T----------?----X|-----o----------------------XE-o-------M--X-----|-------o|-o?-T--E---M--M-------E---|------o--?B?---T-----X------|-f
------------B--|--T-------M----EB----o------oM-?---T---B---------E---?--E-----------------B--E----------B-----M------T-?---M-||----------BE--X----M---o-------E-------X--E-EX-----M-------T--X---------f
--B----?-EM--------EE-X-B-|-----E|E-----T--------?--T-T--E-------X--?-------B-----X---B--|----|BE-------|--oE----|T----|----B-ET|--|--T-TT------o------XM-----------?--------------|--M-M-------o--?--|f
-------X-BEB----------B--||B------T--|-------M----?X-|----------BBB---T------E?-X----X?E--X-B-------------?-------E----o-T----|--X-------o-B--------?----------M------------|---|-o---TT--B------------f
----T-----?---M----B-----MME-M---------T----B?--M------B??|--T?E--------X---M----XTBM---T-X--EX---E-------X-EM--M------------M---o--E?--BE-------M------T--------------|----M-----T--T-----|-----------f
m|------B--E-o---?--X----o?----------MT--M-------M--X-E--T----|-------------M---|------B--X---X-|------B--E---------E-----X----|-------X---o--|--B-M---T---------?---|---E-T-X------E?--------|----X-TBX
XXXXXXXXXXXXXXXXXXXXXXXXXXXXXXXXXXXXXXXXXXXXXXXXXXXXXXXXXXXXXXXXXXXXXXXXXXXXXXXXXXXXXXXXXXXXXXXXXXXXXXXXXXXXXXXXXXXXXXXXXXXXXXXXXXXXXXXXXXXXXXXXXXXXXXXXXXXXXXXXXXXXXXXXXXXXXXXXXXXXXXXXXXXXXXXXXXXXXXXX
