|X--------------------------------TB?o----B------|---------X-BB|--E-------------------B-----------o--o-----B-------|----------------M----------|-----M----------?-----------X-M------X-----------------E
B---o----o|-----------------X---------------------------o--?X-----------------------------M---------------B-------------|---------o-----|---o-------B--?-M--------------------------T----------M-------M
?B-------M---B-|B------B---o----------|---M----------o---|-----------M-?------o-------------M----T-M---B-o-o--------------------------------------------------M---|-------------------------------------
|---------------------Mo------X------------T----?---------------------o---T-----------------T-X-----------------------------------M-T--B------X-----X--------X-T--T------M-----?----T------|-----------B
-B--------------o-------o------------X------------o--?----------|-?-----|-----T--|------T-B-----------o-T---------X--------B-------M----------M---------T------------------o----o---?------------------B
o-|--------------o------------o---?X----X---T---B----------?-----------B---|-------------------T-------|---------o------------------?-oB-|--------------X-------B-T-----B--------------------|----------
T------o-------X------------|----------?-----M-------------?------|-B--------X-----------T--------------B-T---------------------------T---oT------|---------------------?-------------|-?--------------X
X-------X-----?|-?-----?-|-----?----------T-|---TT---------------oB-----B--|---------------M--M-|o---------------Bo-------?--------M--||?---M--?---------?----------o----B-----TXE-------------B-----oXv
T-------o----------------T--M------------------|---BT-------T---|---MM---------o--T--X------------?-----oX----------T-----M------X--B----T-M--X--------------?----?-?------------o--o-------oo-----T---T
E---------X----M-----------B--o--M-------M-------------o-------------------?-B---o-----X---------------M--|E---B-?-----M-o--------B--|--o-------o------T----T|BX--------------B-?----E-----?|-M--------T
E---|-o-X---T--------X------T---?-------------------?-------|M---oo----T---|-o-----oT---Mo------B------T----------o---MX-----B---X--------X----XoT-------X-B-----T--|------o-------T---To--------------B
?o-B-M---|------M-o??----------o--o--B--------T---------o----?--------o----B?--o-----B---------|-------B---|--?o-----------------M|-----------o---oT------|---------X------X-----BB-o---o-------X|M----?
|------o--oo--|------Mo-o----o-----------T?-B--------?TT-----------------B---------|-T--XX-|----------|?-X-?---T---o-?oo--o--------T--BMM-------M--MX?B---o?-------T-----?B-----o-----B-oB------o--o---M
M----T-o-----Bo---B?-B-------oB---------------B-X--??B--?------B---T-T--X?X-T-------To----|-----T--?-Bo--T-T--M-M-|-------|------X?-o---------|MoX|T-----|-B--M----B----o----T---||E----o----MM-X----MME
m---M--o?---XX-|--|------?|--|M--o-|-|-?--XX---o-X---------M--o-o--TM|MX-MoM-TT?X--|-T-oB-?-T-o|T-X---XX-XXBoB--|-----MM--B--oB|M?BBX-?-?-o-?B----|X--B-|T---?o----|-M------o--BX--?--B---|-oM---ToBB?B-
XXXXXXBXoBBXBXXBXTXBXBoBXXBX-BBBBB?BBXXXXXBXBBXX-BBXBBMBXXBXBB-XXXBX-?BBBBXBBB?BXBXXXXBXXXBBBXXXBBBBBXXBBXBXXX-XXXBXB-BoBBXXoXXBXXBB-|BBX-XBBBBBXBBXXBBBXX-BXXBXXXBXBXXBBX-BBBXXXoBXBXXBXBXXBBXXXXXBBB-X
