|-TB----------------------o------B-----------------?----M--------?---|-------------o----------|--------T------------M-----------o-------T-------B----B--------------------M------M--X----o-X---T-------|
B--------------------M---o---------------------T-----------B--M-----------------T---------------?---T---M----E--------|-----B--T----------------o|------------|-------------|---?-X--------E-----?-oo---
-------------o-----------X------M--------X----------------B-X-------------T------------------|M-------?--X---------------------T----------MM--o|--o--------------------------------------B-------------o
o-----X-?-----------o-------o----------oE---------T-----?------------------------|----------------------X---|-?----|-------M----------BT------------E|--------o------------------?-------X---M--X---o---
T--TX---T----------------------B-------o----X---B------T----M------------------------o|--o--X---?-o-----------o-|o---M---------o-B---------------o---oX-----------TTM--B-----M----------M--------------?
T-------o------M------B------|-------|-------------T------|T-------------------------|-E---------------------o---X----o--------E---o-----------------T---------------o-B-------o-B|X------------?---X--B
o-----M------------B----------o--------------------------|oB-----------------------o?------M--?-------M----------o------------M------------------M--------M|-----o----o----T--oo----E---------------o--o
M--------------X--M-------------o-o------------X----?--?-B---o-----oX-----o---------------------B-----------------M---|----------------------B----o----M---------------o---o--oo------------|B----M----v
o-----oT--TBX----X----o-M-------T------X-M-------T---o--------T-------o----------?---o-------T-----o---o---------M---X----B-----M--|----?-----------X---B-----T--?-----o-T----------------------|------T
|-B----------o----------------|-----|?-o---B------o-----?------------------------T-------------------B-----B---------B-X--oBX-o---B---------------o?o-----------------------B-E-o--|oM----o--T-------?-|
M-----X-----o-----B---M--TB-------------X---T--|--?--------------T-XBoB--T-oM-----|Bo?-o----M---B--o--------------------Xo---?o-|-------|-----T-?--o-oT--o---o?-X-X-o--o-------M-o---M-|X---------|----E
T------o---T--B---X-o--------o-----------B-B------T-o----------|o-XM?-?-----------?-o-T-----B--BT---o----|B----B--o-?--o---------X--T---X---------M---------T--T----oB---M-?o|-T-?---M--T-X--------o--M?
E-----M--T-?-----B----T---B-X-?-?o---o?-o-MTT-o-M----|-----?---B----Bo----|----|----o-----T-----o---oo-Boo----------T----?---E--T--|--?--T-o|-o--B-B-B-B----------M|o-B-T-?------oB---B-M---B--o-oB-?TBB
B-B-MT-?-Xo-X---o----MMX--oT|-----o----|---o-----?T--X---B---?-o|o?X-TM---?-------T----?X?X|To-TX-?B---------?-X--?|-|--o?----------o--B---?B---?oT-----o---BTM-?T------T?--------M-?o----Mo--o-X?-X?--E
mB-?M-B--|-oX-X--B-TT--o?Booo-|----|T---Too---B-Xo|-?-?Bo-|T--?-?-X-X-TT?M-?BX-oo---T-|---o-?--?-o----XTo-?T--o-X-M-----oT-MTo-TX--MT-TTo--T--|X-----o|--B-X----|--o?-M----?X-B-T----X----o-|-|---T-o--o
XBBXXXBXXXBXXXXBXBXXXBXXBXBBBXMXBXXBBXXXBBBXBBXXXXBBXX-BBBBBXXXXXXBBXXBBBBXXXXXXXBBBoXXXXBXBXXXBXXXBBBXXXXBXXBXXBBXXX|XBBXX?BBXXXBBX|XXXBXBXMXBXBXXXXBBXBXBXBBXBBBXBXXXXXBXXXXBBXBBBBXBXXXBBXBBXXXXBXX-X
