---?-------B------------T-------------------|--------------------T--X-----|--------B--|-M----M-----T?E---|---------------------------------|-E----------ET------o------------------M-------------------X
X-----oX-E-|---------------------------------------------o--B--B----TTX------?------|-o-E--------------------XBET--------------------------------B-----------?-------|--E--X---------E---------B-------?
X---|----------o-o--------------B--T------------------o-B----|--X-----------------------o-----?--------o-M-----------------------------------------------------T|o----BX-------X----------|------|-----?
E------------o-|---------X--------------------B----B---B---?-----------o-------M------T---?-------------o--X-------------------------------E------------------o-X------M------------------T---------M--B
?-------------M------M------B--X--------E----|---------------------------------------B-----o-------------X?--------------------o-------------?-X----|-M--oT--------------o------------------------T----o
T------T--T----------------XB---X----X-----------------T----------o------o----B--------------T-------------------------o-----?-----?-|---------T-------------BX---------|-|--------------B|E-M---------X
B---?X--T-----|--T-----------?------------------------------X---M---------------|--------o------o---XM----------E------------|----------T|--o---------E--------------o-----------o----|--|-o---------?-o
|o----------B--------------------T---------|-------M-E?--|----X----------X-o----------------------T---------B--T-XM?------------------M----|----B-----------------B--|----------o-----------X------|--?v
T----------E-------------------M-----B----M------T-------------M-o-----------M-------------------X--M-----------|---B-------T---X-----X------T--X----M------------------T---X---o-------X------------|-T
|------X-----T----T-----|--------TB----------?-XX---------------M--------B---o---T--|---------?T--------|---------E------|---------------o------M------------|-----X--M----E----|-----------B----------M
|--B-------X---|---|----------E-------------------M--|T?----------o?------TM---o-------------X----o-----T-?----B---------o---BT--------?-----------|----|-X-oT---?--E|-T--------------B--T---------?---M
TM-TE---T--------X---X------o--------------?---------T-----o------o|--||---------------|--E--------|--X------X-----T|--|-?--------------------X----X---------|------oo-----------|------o----------|---M
B-----B------E-------XB---|-T-----------o-o---------o-----M-----B----?--?-Bo----X-----ooT--o-B-------------?---------XX---T-------o-------o-?------?-T---------?--M--T-X-------Xo------------------|To-?
|------o--|--------------------T----------o--------X--X?---------B-----MX---?---T-T------|-------M?|-|---T--X-----|M|------o-o----o-----------T-------o------o--B-?----o---------|o-X|--B-|----------?-T
m----B-|---------T|-------X---?-----XXX-------X---T--------E-X-|-|-?B-|-M--------oM------T-----------|--|BM---------|o?|-----M--Mo----------?----o------|---B--------?-X---??----|-------|----------oT||
X------XX--XXX-XXX-oXXX-X-XX--XXX---XX----XXXXXXXXXX-M---X-XX-XXXX-Xo--XXX-X-X-----XXX-XXXXMX---X-X--X?B--XT-MXXXXXX-----XXXXXXXXTX-XXT---XXXXX--X--X-X--XXX-XX---XX--XX-XX-XXXXX-XXX--X-X-X-X?--X-XX--X
