----------Eo--------o------?-------------M---------------------------------------------M---------o--------------M--------------E---------------------o------------------------------------------oM------
-------o-----------M-------------------------------------?---------------?-o---------?-------M---------oo---E-------------EB-M-------------------------------X---------------------------------o--------
----------?-------B------------------o-----?--o--------------X--------------M-------B----------o----------?----------o-----B--o-------XM---------Eo----------------X------------------------------------
----------------o--------------------------------?-----------------------------------------------------M--------------------------------------------?---o--BE--------B--------------X--------X----------
--------------------------------------X----------o----X---------------B-----M--------------X------E------------------------o-----o---o------?-----B-------------X-------o----------------X--------------
-----------------?-------XXB--o--E---------X-----XX-o----------X--------X-o--X--------------X--------B------------X---------------X------------X-----------X----------------------------------X-------EM
-o-----------E--------------------E-----X-----------X---X---------X----------XB----X-------X----------X---------------X-----X--------M------------------------oo--------------------X--------------Xo-v-
--X--o--X---X-----------------------?-------E-X-o--------------------X---X-------X----------M----------o-------------------M---B----X-X-----X-----------------------------------------------X-----------
----BX----------------------X------------------------M------M--?---?----------------------X-X---M-----------B-X----oM--X---------------o--o---------o-o-X-------X----?--X----------o------X---X-----o-X-
----M---------------X---------------X?----------X----------------------E----X------o?----------o-----------------------------------X----------------XX----?--X-X-X--E---o--o------------------------o--X
----------------X---------M--X--------o---------X----X?------------XX--X---------X--------------Xo----X-------------X-------------------BX--X--------------M---------X-oX--X-------B----------?---------
XB----T------T-----------------X---?-------X-----X------------T--X-o---------------------X----------------X------------X---------------------X-X---------o-----X-----------o-----------T--X-------T-----
o----?|------|---o-----T----------X-----------TBX---X---------|---X---?-----X-------?--------------------X-----X-X-X--?--B---------T----------E-----------------T-----X-------T------B-|---X------|--E--
------|-X---X|---------|----------------------|----X-T-?------|-T----------------------X-------T----B--Xo--T--X----XXX--X--X----M--|--X---X----------X--X-------|---X-------X-|-----X--|----------|-----
m---X-|------|-----X---|---X---X--X-X---------|-X----|------X-|-|---X--------o------------M----|-------?---|-o-------------X-BE----|--------------B-------------|---X---------|--------|X---------|-----
XX-XXXX-XXXXXXXXXXXXXX--X?XoXX-XX-X-XXXXX-XXXXXXoXXXXXoXXXXXXXXX?X--XXXXX-XXXXX--XXXXMXXXXXXMBXX-XXX-XXXXX-XXXX-X-XXXX-XXXXX-XXXX--XXXX--X-B-XoXXXXXMXXXXX--XX-XXXXXXX-X-X-XX-XXXXX-X-XXMXXX-X?XXBX-Xo-X
