-------------------------------------------------o----------------------B---------------o---------------o----o-----------------------------o------------------------------------------------------------
---------------------------B-------------B-------------------------X---M--------B---------------?-----------------------------------o---E--------------X-?M--------------------E-----------------X------
-----------------------X-----------------------o-----------------------------------o----------X------------------------?-------------------------?------------------o-----------M------------M----------
----------------?------------B------------------BM----------?----M---------M----------------------------------------o?----------------------------------?--------------?-----------------------------?--
----------X---------M-?----?--------B-------------------X----------M-------M-----------M----X-----------------E----o-----------------o-------------------------------------------------X-------------o--
-----------------X------------------?------------------------X------------o-----X-------------M-----E------X--XX-?----------o-----------------------------------------------------------------------X---
-oE-X----------------oBX-B---------------------?----------M----------------?--B-------M-E--?-B----M--X-------------------------X-----------?------?-E---o-----------X-?--------X------------------------
------------------------------------------------X?-----X-------------o--XX---M----------------------E----------o---------------B----o-Xo-----XE---------B---------------X-X------------------X--------Xv
-X------------------------------------------B----X-------E------------X-------------------------------------------X--X-----------------?---------M----------X----E----o-E-?-----------------------------
-----------------B--X------------?X----------------B-------X------------B--X?------------------------X-----------------X-X---------------------------Bo-X---------------------------------E--------X----
X---------X--?---M----X---------------------?-----------------X------------o----------------B---X---X----------o---------o----X-----------------?--------------------------o-----------X-----X-------X--
----------------X--------MT-X-----T--------------------------XX---------M--------T------XX---M----------X--B--X?--X--XT-------------------------XX--------------T------XX---X----------o------T-Mo------
----------X-------X-------|-----T-|M--B---X----------------------o------X--------|------X---?---------XX-T--B-E----X--|-----X-----------o-----------------------|-XX---X-X--XX---B------X--TEX|---X-----
--------------------T-----|-----|-|X--o----------X----X-------X-------oX-----T-X-|---T---X---------------|X-----------|------------------X-X------B-----X---X---|-------X-X---M------------|B-|---------
m----X-X-------B-X--|-----|-----|-|-X-----------------?---XXX-----X----------|X-X|---|--X-----------X-X--|-X----E-----|------------o--M----------X--------------|---X----X-----------------|-X|---------
XX-?X--XXXXXXoXXXXXX--X-XXXXXXXXMXX-XoXXXoXXXXXXXXXoX-XX-X-XXX-XXXX-X-XXXXXX-XX-BXXXXX-XXXoX-XXXXX-X--XXXX?XXXXXXXXXXBX-XXXXoXX-X-X-XXXXXXXXXX-XXXX-XXXXXXXXXXXXX-X-XXXXXX-XXXXX-XXXXXXXX-XXXXXXX---XX-X
